6,6,6,6,6,6,6,6,6,6,6,6,6,6,6,6,6,6,6,6,6,6,6,6,6,6,6,6,6,6,6,6
6,6,6,6,6,6,6,6,6,6,6,6,6,6,6,6,6,6,6,6,6,6,6,6,6,6,6,0,0,6,6,6
6,6,6,6,6,6,4,4,6,6,6,6,6,6,6,6,6,6,6,6,6,6,6,6,6,6,6,0,0,0,6,6
6,6,6,6,6,4,4,4,4,6,6,6,6,6,6,6,6,0,6,6,6,6,6,6,0,6,6,6,6,6,6,6
6,6,6,6,6,4,4,4,4,4,6,6,6,6,6,6,6,6,6,6,6,6,6,6,6,6,6,0,6,6,6,6
6,6,6,6,4,4,4,4,4,4,6,6,6,6,6,0,6,6,6,6,6,6,6,6,6,6,6,0,0,6,6,6
6,6,6,6,4,4,4,6,6,6,6,6,6,6,6,0,6,6,6,0,0,0,6,0,0,0,6,6,6,6,6,6
6,6,6,6,6,6,6,6,6,6,6,6,6,6,6,6,6,6,6,6,6,6,6,6,6,6,6,6,6,6,6,6
2,2,2,2,2,2,2,2,2,2,2,2,2,2,2,2,2,3,2,2,2,2,2,2,2,2,2,2,2,2,2,2
6,6,6,6,6,6,6,6,6,6,0,0,6,6,6,6,6,1,6,6,6,6,6,6,6,6,6,6,6,6,6,6
6,6,6,6,6,0,0,0,6,6,6,0,6,6,0,6,6,1,6,6,0,6,6,6,6,6,6,6,6,6,6,6
6,6,6,6,0,6,6,6,6,6,6,6,6,6,0,0,6,1,6,6,0,6,6,4,4,4,4,6,6,6,6,6
6,6,0,0,0,6,6,6,6,4,4,4,6,6,6,0,6,1,6,6,0,6,6,4,4,4,4,4,4,6,6,6
6,6,6,6,6,6,4,4,4,4,4,4,6,6,6,0,6,1,6,6,6,6,6,4,4,4,4,4,4,4,6,6
6,6,0,6,6,6,4,4,4,4,4,4,6,6,0,6,6,1,6,6,6,0,6,6,4,4,4,4,4,4,6,6
6,6,6,6,6,6,6,6,4,4,4,6,6,6,6,0,0,1,6,6,6,0,0,6,6,6,6,6,6,6,6,6
6,6,6,6,6,6,6,6,6,6,6,6,6,6,6,6,0,1,6,6,6,6,6,6,6,6,6,6,6,6,6,6
6,6,6,6,0,6,6,6,6,6,6,6,6,6,6,6,6,1,6,6,6,6,6,6,6,6,6,6,6,6,6,6
